12 12
WWWWWWWWWWWW
W___WWW___WW
W_E_____E_WW
W___WWW___WW
W___WWW___WW
WW_WWWWWWWWW
WW_WWWWWWWWW
W___WWW___WW
W___WWW_P_WW
W_________WW
WG__WWW___WW
WWWWWWWWWWWW